# Tank Game Map
name Test Arena
tile_size 2.0
music march

# Tile definitions
tile . wood_oak_brown
tile # wood_rustic_dark
tile : mud_wet
tile * carpet_gray
tile w water_caustic
tile c cobble
tile t test_grid
tile s slime
tile m mud_dry

# Object tags
tag P1 spawn angle=0.785 team=0 team_spawn=0
tag P2 spawn angle=2.356 team=0 team_spawn=0
tag P3 spawn angle=-0.785 team=0 team_spawn=0
tag P4 spawn angle=-2.356 team=0 team_spawn=0
tag E1 enemy angle=3.107 type=sniper
tag B barrier tile=cobble health=20.0
tag BP barrier tile=cobble health=15.0
tag PB powerup type=barrier_placer respawn=30.0 barrier=BP barrier_count=5 barrier_lifetime=8.0
tag E2 enemy angle=2.312 type=hunter
tag W1 powerup type=machine_gun respawn=15.0

water_level 0
water_color 1.00 0.25 0.00
wave_strength 5.0
wind_direction 0.20
wind_strength 1.2

fog_level 0
fog_color 0.00 0.60 0.70

toxic_cloud enabled
toxic_delay 10.0
toxic_duration 90.0
toxic_safe_zone 0.20
toxic_damage 1
toxic_interval 5.0
toxic_slowdown 0.70
toxic_color 0.20 0.80 0.30
toxic_center 11.50 6.50

<grid>
   2#    2#    2#    2#    2#    2#    2#    2#    2#    2#    2c    2#    2#    2c    2#    2#    2#    2#    2#    2#    2#    2#    2#    2# 
   2# 0.|P1    0.    0.  0.|B    0m    0:    0.    0.    0.    2c   10c   10c    2c    0.    0.    0.    0:    0m  0.|B    0.    0.    0.    2# 
   2#    0.    0.    0.  0.|B    0m    2:    0.    0.    0.    1c   10c   10c    1c    0.    0.    0.    2:    0:  0.|B    0. 0.|E2    0.    2# 
   2#    0.    0.    0.  0.|B    0m 0:|W1    0.    0.    0.    0.   10c   10c    0c    0.    0.    0.    0:    0m  0.|B    0.    0.    0.    2# 
   2#    2#    2#   10c  0.|B    0s    0s    0s    0s    0s    0s    0c    0c    0s    0s    0s    0s    0s    0s  0.|B   10c    2#    2#    2# 
   2#    0.    0.    0.    0c   -2.   -2.   -2.   -2.   -2.   -2.   -2.   -2.   -2.   -2.   -2.   -2.   -2.   -2.    0c    0.    0.    0.    2# 
   2#    0.    0. 0.|W1    0c    0c    0c    0c    0c    0c    0c    0c 0c|E1    0c    0c    0c    0c    0c    0c    0c    0.    0.    0.    2# 
   2#    0.    0.    0.    0c    0c    0c    0c    0c    0c    0c    0c 0c|E1    0c    0c    0c    0c    0c    0c    0c    0.    0.    0.    2# 
   2#    0.    0.    0.    0c   -2.   -2.   -2.   -2.   -2.   -2.   -2.   -2.   -2.   -2.   -2.   -2.   -2.   -2.    0c    0.    0.    0.    2# 
   2#    2#    2#   10c  0.|B    0s    0s    0s    0s    0s    0s    0c    0c    0s    0s    0s    0s    0s    0s  0.|B   10c    2#    2#    2# 
   2#    0.    0.    0.  0.|B    0m    0:    0.    0.    0.    0.   10c   10c    0.    0.    0.    0.    0:    0m  0.|B    0.    0.    0.    2# 
   2#    0. 0.|E2    0.  0.|B    0m    2:    0.    0.    0.    1c   10c   10c    1c    0.    0. 0.|W1    2:    0m  0.|B    0. 0.|E1    0.    2# 
   2#    0.    0.    0.  0.|B    0m    0:    0.    0.    0.    2c   10c   10c    2c    0.    0.    0.    0:    0m  0.|B    0.    0.    0.    2# 
   2#    2#    2#    2#    2#    2#    2#    2#    2#    2#    2c    2#    2#    2c    2#    2#    2#    2#    2#    2#    2#    2#    2#    2# 
</grid>

# Lighting
sun_direction 0.78 -0.59 0.22
sun_color 0.95 0.90 0.80
ambient_color 0.12 0.12 0.15
ambient_darkness 0.85
