name Blend Test
tile_size 2.0

tile . wood_pine_light
tile # wood_walnut
tile : mud_wet
tile , cobble

<grid>
8# 8# 8# 8# 8# 8# 8# 8# 8# 8# 8# 8# 8# 8# 8# 8#
8# 0. 0. 0. 0. 0. 0. 0. 0. 0, 0, 0, 0, 0# 0# 8#
8# 0. 0. 0. 0. 0: 0: 0: 0: 0, 0, 0, 0, 0# 0# 8#
8# 0. 0. 0. 0. 0: 0: 0: 0: 0, 0, 0, 0, 0# 0# 8#
8# 0. 0. 0. 0. 0: 0: 0: 0: 0, 0, 0, 0, 0# 0# 8#
8# 0. 0. 0. 0. 0: 0: 0: 0: 0, 0, 0, 0, 0# 0# 8#
8# 0. 0. 0. 0. 0: 0: 0: 0: 0, 0, 0, 0, 0# 0# 8#
8# 0. 0. 0. 0. 0: 0: 0: 0: 0, 0, 0, 0, 0# 0# 8#
8# 0. 0. 0. 0. 0: 0: 0: 0: 0, 0, 0, 0, 0# 0# 8#
8# 8# 8# 8# 8# 8# 8# 8# 8# 8# 8# 8# 8# 8# 8# 8#
</grid>

sun_direction 0.3 -0.8 0.2
sun_color 1.0 0.98 0.9
