# Tank Game Map
version 1
name Test Arena
size 24 14
tile_size 2.0

terrain
########################
#......................#
#..##....##....##......#
#..##....##....##...*..#
#............*....***..#
#....::......*....*....#
#....::................#
#......................#
#......................#
#........~~......##....#
#........~~......##....#
#..##..................#
#..##....##....##......#
########################

heights
222222222222222222222222
200000000000000000000002
200220000220000220000002
200220000220000220000002
200000000000000000000002
200000000000000000000002
200000000000000000000002
200000000000000000000002
200000000000000000000002
200000000000000000220002
200000000000000000220002
200220000000000000000002
200220000220000220000002
222222222222222222222222

spawn 4.00 4.00 0.785 0 0
spawn 44.00 4.00 2.356 0 0
spawn 4.00 24.00 -0.785 0 0
spawn 44.00 24.00 -2.356 0 0
