# Tank Game Map
version 1
name Test Arena
size 16 16
tile_size 2.0

terrain
################
#..............#
#..##....##....#
#..##....##..*.#
#..........***.#
#....::.....*..#
#....::........#
#..............#
#..............#
#........~~....#
#........~~....#
#..##..........#
#..##....##....#
#........##....#
#..............#
################

heights
2222222222222222
2000000000000002
2002200002200002
2002200002200002
2000000000000002
2000000000000002
2000000000000002
2000000000000002
2000000000000002
2000000000000002
2000000000000002
2002200000000002
2002200002200002
2000000002200002
2000000000000002
2222222222222222

spawn 4.00 4.00 0.785 0 0
spawn 28.00 4.00 2.356 0 0
spawn 4.00 28.00 -0.785 0 0
spawn 28.00 28.00 -2.356 0 0
